Первые слова

rarely - редко
applaud - аплодировать
sure - конечно или уверен
quarrel - ссора
past - прошлое (например past 10 years - последние 5 лет)
each - каждый
even - даже
their - их
tell - говорить
put - ставить
large - большой
spell - читать по буквам
land - земля
grass - трава
glass - стекло
stick - палка
brick - кирпич
building - здание
build - строить
sand - песок
protection - защита
safety - безопасность
such - такой
act - действовать

07.07 - new

take photos - делать фото
fix things -  исправлять положение вещей
friendly — дружелюбный — [ˈfrɛnd.li]
She is very friendly to everyone.

polite — вежливый — [pəˈlaɪt]
He is always polite with customers.

lazy — ленивый — [ˈleɪ.zi]
My cat is lazy and sleeps all day.

hardworking — трудолюбивый — [ˌhɑːdˈwɜː.kɪŋ]
She is a hardworking student.

talkative — разговорчивый — [ˈtɔː.kə.tɪv]
He is very talkative and loves chatting.

quiet — тихий, спокойный — [ˈkwaɪ.ət]
My sister is quiet and shy.

smart — умный — [smɑːt]
You are very smart. Good job!

boring — скучный — [ˈbɔː.rɪŋ]
The lesson was boring, I almost fell asleep.

funny — смешной — [ˈfʌn.i]
That movie is really funny!

serious — серьёзный — [ˈsɪə.ri.əs]
He looks serious, but he has a good sense of humor.


